[
  {
    "type": "mapgen",
    "method": "json",
    "om_terrain": [ "skyway_straight" ],
    "weight": 500,
    "object": {
      "fill_ter": "t_floor",
      "rows": [
        "`|   |``````````````````",
        "`=   =``````````````````",
        "`=   =``````````````````",
        "`=   =``````````````````",
        "`=   =``````````````````",
        "`=   =``````````````````",
        "`=   =``````````````````",
        "`=   =``````````````````",
        "`=   =``````````````````",
        "`=   =``````````````````",
        "`=   =``````````````````",
        "`=   =``````````````````",
        "`=   =``````````````````",
        "`=   =``````````````````",
        "`=   =``````````````````",
        "`=   =``````````````````",
        "`=   =``````````````````",
        "`=   =``````````````````",
        "`=   =``````````````````",
        "`=   =``````````````````",
        "`=   =``````````````````",
        "`=   =``````````````````",
        "`=   =``````````````````",
        "`|   |``````````````````"
      ],
      "palettes": [ "skyway" ]
    }
  },
  {
    "type": "mapgen",
    "method": "json",
    "om_terrain": [ "skyway_end" ],
    "weight": 500,
    "object": {
      "fill_ter": "t_floor",
      "rows": [
        "````````````````````````",
        "````````````````````````",
        "````````````````````````",
        "````````````````````````",
        "````````````````````````",
        "````````````````````````",
        "````````````````````````",
        "````````````````````````",
        "````````````````````````",
        "````````````````````````",
        "````````````````````````",
        "````````````````````````",
        "````````````````````````",
        "````````````````````````",
        "````````````````````````",
        "````````````````````````",
        "````````````````````````",
        "````````````````````````",
        "`||||||================|",
        "`+    =                 ",
        "`+    +                 ",
        "`+    =                 ",
        "`||||||================|",
        "````````````````````````"
      ],
      "palettes": [ "skyway" ]
    }
  },
  {
    "type": "mapgen",
    "method": "json",
    "om_terrain": [ "skyway_curved" ],
    "weight": 500,
    "object": {
      "fill_ter": "t_floor",
      "rows": [
        "`|   |``````````````````",
        "`=   =``````````````````",
        "`=   =``````````````````",
        "`=   =``````````````````",
        "`=   =``````````````````",
        "`=   =``````````````````",
        "`=   =``````````````````",
        "`=   =``````````````````",
        "`=   =``````````````````",
        "`=   =``````````````````",
        "`=   =``````````````````",
        "`=   =``````````````````",
        "`=   =``````````````````",
        "`=   =``````````````````",
        "`=   =``````````````````",
        "`=   =``````````````````",
        "`=   =``````````````````",
        "`|   |``````````````````",
        "`|   ||================|",
        "`=                      ",
        "`=                      ",
        "`=                      ",
        "`|===||================|",
        "````````````````````````"
      ],
      "palettes": [ "skyway" ]
    }
  },
  {
    "type": "mapgen",
    "method": "json",
    "om_terrain": [ "skyway_tee" ],
    "weight": 500,
    "object": {
      "fill_ter": "t_floor",
      "rows": [
        "`|   |``````````````````",
        "`=   =``````````````````",
        "`=   =``````````````````",
        "`=   =``````````````````",
        "`=   =``````````````````",
        "`=   =``````````````````",
        "`=   =``````````````````",
        "`=   =``````````````````",
        "`=   =``````````````````",
        "`=   =``````````````````",
        "`=   =``````````````````",
        "`=   =``````````````````",
        "`=   =``````````````````",
        "`=   =``````````````````",
        "`=   =``````````````````",
        "`=   =``````````````````",
        "`|   |``````````````````",
        "`|   |``````````````````",
        "||   |||===============|",
        "                        ",
        "                        ",
        "                        ",
        "||||||||===============|",
        "````````````````````````"
      ],
      "palettes": [ "skyway" ]
    }
  },
  {
    "type": "mapgen",
    "method": "json",
    "om_terrain": [ "skyway_four_way" ],
    "weight": 500,
    "object": {
      "fill_ter": "t_floor",
      "rows": [
        "`|   |``````````````````",
        "`=   =``````````````````",
        "`=   =``````````````````",
        "`=   =``````````````````",
        "`=   =``````````````````",
        "`=   =``````````````````",
        "`=   =``````````````````",
        "`=   =``````````````````",
        "`=   =``````````````````",
        "`=   =``````````````````",
        "`=   =``````````````````",
        "`=   =``````````````````",
        "`=   =``````````````````",
        "`=   =``````````````````",
        "`=   =``````````````````",
        "`=   =``````````````````",
        "`|   |``````````````````",
        "`|   |``````````````````",
        "||   |||===============|",
        "                        ",
        "                        ",
        "                        ",
        "||   |||===============|",
        "`|   |``````````````````"
      ],
      "palettes": [ "skyway" ]
    }
  }
]
