[
    {
        "type": "mapgen",
        "nested_mapgen_id": "afs_cross_habitat_end_z2",
        "method": "json",
        "object": {
          "mapgensize": [ 24, 24 ],
          "rows": [
            "                        ",
            "                        ",
            "                        ",
            "               }}}}     ",
            "  //           }..} //  ",
            "  /            }xx}  /  ",
            "  //      //////..} //  ",
            "          /..._#..}     ",
            "          /.////..}     ",
            "   }}}}}}}/./  }..}     ",
            "  //.....E/./  }..} //  ",
            "  /6.....E/#/}}}..}  /  ",
            "  /6............xx}  /  ",
            "  //.....L/#/}}}..} //  ",
            "   }}}}}}}/./  }..}     ",
            "          /./p }..}     ",
            "   ppppppp/./p /!!/     ",
            "  //      /.////../ //  ",
            "  /       /./p./!!/  /  ",
            "  //    ///./p....= //  ",
            "        /_../p..xx=     ",
            "        ///./p....=     ",
            "          /./p....//    ",
            "          /./p...../    "
          ],
          "flags": [ "ERASE_ALL_BEFORE_PLACING_TERRAIN" ],
          "palettes": [  "afs_habitat_structure" ],
          "terrain": {
            "_": "t_metal_floor_no_roof",
            " ": "t_open_air"
          }
        }
        }
]