[
    {
        "type": "mapgen",
        "nested_mapgen_id": "afs_cross_habitat_end_z1",
        "method": "json",
        "object": {
          "mapgensize": [ 24, 24 ],
          "rows": [
            "........................",
            "...=======/../=======...",
            "...=      ////      =...",
            "...=      :  :      =...",
            "..///#////////      //..",
            "../          /       /..",
            "..///#////// ///    //..",
            "...=       / #./    =...",
            "...=       /////    =...",
            "...=                =...",
            "..//                //..",
            "../                 3/..",
            "../                 3/..",
            "..//////  ////////:://..",
            "...=000/  /00/B     =...",
            "...=   !  !  !  kh  =...",
            "...=000/  /00/ hk   =...",
            "..//////  ///|:|||!|||..",
            "../&^:    :^&| h2| :1|..",
            "..||||!||#||||kk |!|||..",
            "...=    |.|VV|)))|  =...",
            "...= A  |||         =...",
            "...= a  |V==]| tt   =...",
            "..//    |    |bbbb  //.."
          ],
          "flags": [ "ERASE_ALL_BEFORE_PLACING_TERRAIN" ],
          "palettes": [  "afs_habitat_structure" ],
          "terrain": {
            ".": "t_open_air"
          }
        }
        }
]